XXXXXXXXXXXXXXXXXXXXXXXXXXXXXXXXXXXXXXXX
X  XX                 X           3    X
X     XXX             XX  #            X
X                         #            X
XXXXX     X  #  ###X  X   X        XXXXX
X                         X   1 X      X
X     X  #    XXXXX       X     X      X
X     X           #    ## X     X      X
X   2 X           #       X            X
XXXXXXX  XXX#       XXX X###XXX     XXXX
X     XXXXX               X            X
P             X     ##    #X    # ##   X
X         ##  X           XX           X
X    X   X     #X              X       O
X         #              X   XX        X
X     2   X      2    #XX   X      1   X
X X   ###### #X                XXXX    X
X          #        #          X   X   X
X#       #                     X       X
XXXXXXXXXXXXXXXXXXXXXXXXXXXXXXXXXXXXXXXX