XXXXXXXXXXXXXXXXXXXXXXXXXXXXXX
X                     X      X
X                     XX     X
X                            X
X#########X  #  ###X  X      X
X                            X
X     X  #    XXXXX          X
X     X           #    ##    X
X     X           #          X
XXXXXXX  XXX# XXXXXXXXX X### X
X                            X
X             X     ##    #X X
X         ##  X           XX X
X    X   X     #X            X
X         #                  X
X        ###                 X
X X   ###   #X               X
X          #        #        X
X#       #                   X
XXXXXXXXXXXXXXXXOXXXXXXXXXXXXX