XXXXXXXXXXXXXXXXXXXXXXXXXXXXXXXXXXXXXXXX
X                     X                X
X                     XX               X
X                                      X
X#########X  #  ###X  X            XXXXX
X                               X      X
X     X  #    XXXXX             X      X
X     X           #    ##       X      X
X     X           #                    X
XXXXXXX  XXX# XXXXXXXXX X###XXX     XXXX
X                                      X
X             X     ##    #X    # ##   X
X         ##  X           XX           X
X    X   X     #X              X       O
X         #                    XXXXX   X
X        ###          ####  #  XXXXX   X
X X   ###   #X                 XXXXX   X
X          #        #          XXXXX   X
X#       #                     X       X
XXXXXXXXXXXXXXXXXXXXXXXXXXXXXXXXXXXXXXXX