XXXXXXXXXXXXXXXXXXXXXXXXXXXXXXXXXXXXXXXX
X                     X                X
X      3               XX     1        X
X                                      X
X#########X  #  ###X  X            XXXXX
X                           3   X      X
X     X  #    XXXXX             X      X
X     X           #    ##       X      X
X     X           #                    X
XXXXXXX  XXX# XXXXXXXXX X###XXX     XXXX
X                              3       X
X             X     ##    #X    # ##   X
X         ##  X           XX           X
X    X   X     #X              X       O
X         #                    XXXXX   X
X        ###     2    ####  #  XXXXX   X
X X   ###   #X                 XXXXX   X
X          #        #          XXXXX   X
X#       #                     X       X
XXXXXXXXXXXXXXXXXXXXXXXXXXXXXXXXXXXXXXXX