XXXXXXXXXXXXXXXXXXXXXXXXXXXXXXXXXXXXXXXX
X                     X                X
X                     XX               X
X                                      X
X####    #X  #  ###X  X            XXXXX
X                               X      X
X     X  #    XXXXX             X      X
X     X           #    ##       X      X
X     X           #                    X
XXXXXXX  XX                #XXX     XXXX
X                                      X
X             X     ##    #X    # ##   X
X         ##  X           XX           X
X    X   X     #X              X       X
X         #                    XXXXX   X
X        ###          ####  #          X
X X   ###   #X                 XXXXX   X
X          #        #                  X
X#       #                     X       X
XXXXXXXXXXXXXXXXOXXXXXXXXXXXXXXXXXXXXXXX