XXXXXXXXXXXXXXXXXXXXXXXXXXXXXXXXXXXXXXXX
X       #     3        X               X
X       #      3        XX     1       X
X               3                      X
X#########X  #  ###X  X            XXXXX
X                3               X     X
X     X  #    XXXXX 3            X     X
X     X           #    ##       X      X
X     X           #  3                 X
XXXXXXX  XXX# XXXXXXXXX X###XXX     XXXX
X                     3                X
X             X     ##    #X    # ##   X
X         ##  X           XX           X
X    X   X     #X      3       XXX     O
X         #                    X X X   X
X        ###     2    ####  #  X X X   X
X X   ###   #X          3      X   X   X
X          #        #          X#XXX   X
X#       #                     X       X
XXXXXXXXXXXXXXXXXXXXXXXXXXXXXXXXXXXXXXXX